+-----------------------------------------------------------------------------+
|                                                                             |
|  CAFETARIA                                                                  |
|                                                                             |
|                                                                             |
|                                                                             |
|                                                                             |
|                                                                             |
|                                                                             |
|                                                                             |
|                                                                             |
|                                                                             |
|                                                                             |
|                                                                             |
|                                                                             |
|                                                                             |
|                                                                             |
|                                                                             |
|                                  ASCII ART                                  |
|                                                                             |
|                                                                             |
|                                                                             |
|                                                                             |
|                                                                             |
|                                                                             |
|                                                                             |
|                                                                             |
|                                                                             |
|                                                                             |
|                                                                             |
|                                                                             |
|                                                                             |
|                                                                             |
|                                                                             |
+-----------------------------------------------------------------------------+
|                                                                             |
|                                                                             |
|  Room description                                                           |
|                                                                             |
|                                                                             |
+-----------------------------------------------------------------------------+
