+-----------------------------------------------------------------------------+
|                                                                             |
|                                                                             |
|                                                                             |
|                                                                             |
|                                                                             |
|                                                                             |
|                                                                             |
|                                                                             |
|                                                                             |
|                                                                             |
|                                                                             |
|                           ASCII ART OF OFFICE                               |
|                                                                             |
|                                                                             |
|                                                                             |
|                                                                             |
|                                                                             |
|                                                                             |
|                                                                             |
|                                                                             |
|                                                                             |
+-----------------------------------------------------------------------------+
|                                                                             |
|                                                                             |
|                                                                             |
|                       DISPLAY SUSPECTS IN THE ROOM                          |
|                                                                             |
|                                                                             |
|                                                                             |
+-----------------------------------------------------------------------------+
|                                                                             |
|                                                                             |
|                                                                             |
|                                                                             |
|                         DISPLAY ROOM DETAILS                                |
|                                                                             |
|                                                                             |
|                                                                             |
|                                                                             |
+-----------------------------------------------------------------------------+
